#................#
#................#
#................#
#.@....#...#....!#
$$$$$$$$$$$$$$$$$$