#................#
#................#
#................#
#.@....^...>....!#
$$$$$$$$$$$$$$$$$$