#................#
#................#
#................#
#.@..^.^.^.^.^.!.#
$$$$$$$$$$$$$$$$$$