#.............#..#
#.............#..#
#k...>>>>.....#..#
#########...@.[.!#
###########$$$$$$$