#................#
#@...........#..!#
##...#....#.....##
#.......#........#
#^^^^^^^^^^^^^^^^#
##################