#................#
#....^..^.^..^..k#
#@..##############
##..#............#
#.#.[...........!#
#..###.#.#..#..###
#$$$$$^^^^^^^^^^^#
##################