#...............!#
#.........>^.#####
#.........##.....#
#@.....#..##....^#
#$$$$$$$$$$$$$$$$#